The Ragged Trousered Philanthropists - Robert Tressell.txt, 
Of Mice and Men - John Steinbeck.txt, 
Stephen-King-The-Long-Walk_-1979.txt, 
The Thirty-nine Steps - John Buchan.txt, 
KANE AND ABEL by JEFFREY ARCHER.txt, 
The Picture of Dorian Gray by Oscar Wilde.txt, 
Harry Potter and the Half-Blood - J.K. Rowling.txt, 
Andrzej Sapkowski - The Witcher 04 Time of Contempt - 2013.txt, 
Brave New World - Aldous Leonard Huxley.txt, 
Harry Potter and the Prisoner o - J.K. Rowling.txt, 
The Count of Monte Cristo - Alexandre Dumas.txt, 
A Feast For Crows - George R. R. Martin.txt, 
Heidi - Johanna Spyri.txt, 
Harry Potter and the Sorcerer's - J.K. Rowling.txt, 
Harry Potter and the Chamber of - J.K. Rowling.txt, 
Nemesis Games - James S. A. Corey.txt, 
Discworld_35_Wintersmith.txt, 
Ulysses - James Joyce.txt, 
08 Season of Storms (2013) - Stephen Hulin [Kinetic IT].txt, 
Don Quixote - Miguel de Cervantes.txt.txt, 
TheHitchhikersGuideToTheGalaxy - Vladimir Romanov.txt, 
A Game Of Thrones - George R. R. Martin.txt, 
GULLIVER'S TRAVELS INTO SEVERAL REMOTE REGIONS OF THE WORLD - JONATHAN SWIFT.txt, 
Matilda.txt, 
Memoirs Of A Geisha - Arthur Golden.txt, 
Crime and Punishment - Fyodor Dostoevsky.txt, 
Anna Karenina - Leo Tolstoy.txt, 
04 Times of Contempt (1995) - Stephen.txt, 
EVELYN WAUGH -  MEMORIES OF CAPTAIN CHARLES RYDER.txt, 
07 The Lady of the Lake (1999) - Stephen Hulin.txt, 
The Turn of the Screw - Henry James.txt, 
Babylon's Ashes - James S. A. Corey.txt, 
Lord of the flies - William Golding.txt, 
The Great Gatsby - F. Scott Fitzgerald.txt, 
The Foul Ball - By John Irving.txt, 
The Provost - John Galt.txt, 
The Phantom of the Opera - Gaston Leroux.txt, 
Fantastic Beasts and Where to F - J. K. Rowling.txt, 
Metamorphosis - Franz Kafka.txt, 
GoneWithTheWind - Shahid Riaz.txt, 
WorldWithoutEnd - Ken Follet.txt, 
Andrzej Sapkowski - The Witcher 01 The Last Wish - 2007.txt, 
Cibola Burn - James S. A. Corey.txt, 
Stephen-King-Roadwork_-1981.txt, 
The Return of Sherlock Holmes - Arthur Conan Doyle.txt, 
Memoirs of Fanny Hill - John Cleland.txt, 
GOOD OMENS - Neil Gaiman and Terry Pratchett.txt, 
Abaddon's Gate - James S. A. Corey.txt, 
The Da Vinci Code - Unknown.txt, 
Charlie and the Chocolate Factory - ROALD DAHL.txt, 
Notes from the Underground - Fyodor Dostoyevsky.txt, 
The Strange Case of Dr. Jekyll - Robert Louis Stevenson.txt, 
Grabriel García Márquez LOVE in the TIME of CHOLERA.txt, 
Discworld_37_Unseen_Academicals.txt, 
Lee, Harper—To Kill a Mockingbird.txt, 
Discworld 01 - The Colour of Ma - Norton.txt, 
Moby Dick by Herman Mellville.txt, 
Caliban;s war e-2 - James S.A. Corey.txt, 
Memoirs of Sherlock Holmes - SIR ARTHUR CONAN DOYLE.txt, 
Artemis Fowl - EoinColfer.txt, 
The War of the Worlds by H. G. Wells.txt, 
Harry Potter and the Methods of - Eliezer Yudkowsky.txt, 
Siddhartha - Hermann Hesse.txt, 
Harry Potter and the Deathly Ha - J.K. Rowling.txt, 
A Tale of Two Cities By Charles Dickens.txt, 
Andrzej Sapkowski - Blood of El - DragonAshe.txt, 
Dracula - by Bram Stoker.txt, 
A CHRISTMAS CAROL By CHARLES DICKENS.txt, 
A Clash of Kings - George R. R. Martin.txt, 
Stephen-King-Bag-of-Bones_-1998.txt, 
ADVENTURES OF TOM SAWYER - Twain.txt, 
The Thorn Birds - Colleen Mccullough.txt, 
THE PILGRIM'S PROGRESS - John Bunyan.txt, 
Little Women by Louisa May Alcott.txt, 
JOHN MILTON -  PARADISE LOST.txt, 
Captain Corelli's Mandolin.txt, 
Holes - Louis Sachar.txt, 
Andrzej_Sapkowski_The_Witcher_06.txt, 
A Dance With Dragons_ Book 5 of - George R. R. Martin.txt, 
TESS OF THE D'URBERVILLES - Thomas Hardy.txt, 
Harry Potter and the Order of t - J.K. Rowling.txt, 
the stand - Stephen King.txt, 
TREASURE ISLAND by Robert Louis Stevenson.txt, 
06 The Tower of the Swallow (19 - Dominik.txt, 
Rebecca - Daphne du Maurier.txt, 
Stephen-King-Thinner_-1984.txt, 
The Scarlet Letter - Nathaniel Hawthorne.txt, 
Stephen-King-The-Running-Man_-1982.txt, 
Jane Eyre - e-booksdirectory.com.txt, 
The Wonderful Wizard of Oz - L. Frank Baum.txt, 
Dan Brown - Origin - 2017.txt, 
Twenty Thousand Leagues Under t - Jules Verne.txt, 
Watership Down.rtf - Darcy.txt, 
Discworld_04_Mort.txt, 
EMMA - JANE AUSTEN.txt, 
The Lion, The With and the wardrobe - C.S. Lewis.txt, 
Pinocchio - Carlo Collodi.txt, 
Stephen-King-The-Regulators_-1996.txt, 
Oliver Twist by Charles Dickens.txt, 
Vanity Fair - William Makepeace Thackeray.txt, 
Tales of Terror and Mystery - SIR ARTHUR CONAN DOYLE.txt, 
THE JUNGLE by Upton Sinclair.txt, 
The Wind in the Willows - Kenneth Grahame.txt, 
ONE HUNDRED YEARS OF SOLITUDE - GABRIEL GARCIA MARQUEZ.txt, 
A TOWN LIKE ALICE - NEVIL SHUTE.txt, 
Dubliners - James Joyce.txt, 
Andrzej_Sapkowski_The_Witcher_02.txt, 
Grimm's Fairy Stories - Unknown.txt, 
Persuasion (Norton Critical Edi - Jane Austen.txt, 
The Call of the Wild - Jack London.txt, 
Pride and Prejudice By Jane Austen.txt, 
HUCKLEBERRY FINN - Mark Twain.txt, 
David Copperfield - Charles Dickens.txt, 
Nostromo - Joseph Conrad.txt, 
Leviathan Wakes e-1 - James S.A. Corey.txt, 
NORTHANGER ABBEY by Jane Austen.txt, 
Discworld_26_Thief_of_Time.txt, 
Alice in Wonderland - Lewis Carroll.txt, 
Middlemarch - George Eliot.txt, 
There are five children in this - Aung Myo Min.txt, 
05 Baptism of Fire (1996) - Rebecca Nettleship.txt, 
02-Short Stories-The Sword of D - Bradbury.txt, 
The Lost World - SIR ARTHUR CONAN DOYLE.txt, 
Les Misrables - Victor Hugo.txt, 
THE CATCHER IN THE RYE - Jeff Marsden.txt, 
The Lord of the Rings - JRR Tolkien.txt, 
BLACK BEAUTY By Anna Sewell.txt, 
Leviathan Wakes - James S.A. Corey.txt, 
Frankenstein , or the Modern Prometheus - Mary Wollstonecraft (Godwin) Shelley.txt, 
Eugenie Grandet - Honore de Balzac.txt, 
Animal Farm - George Orwell.txt.txt, 
Hlen Fielding - Bridget Jones's Diary.txt, 
1984- GEORGE ORWELL.txt, 
A Storm of Swords - George R. R. Martin.txt, 
Discworld_32_A_Hat_Full_Of_Sky.txt, 
Good Night, Mr. Tom Michelle Magorian.txt, 
Wuthering Heights - Unknown.txt, 
The Legend of Sleepy Hollow - Washington Irving.txt, 
Madame Bovary - Gustave Flaubert.txt, 
War and Peace - Unknown.txt, 
Salman Rushdie - Midnight's children.txt, 
Andrzej Sapkowski The Last Wish - DragonAshe.txt, 
Harry Potter and the Goblet of - J.K. Rowling.txt, 
The Last of the Mohicans - James Fenimore Cooper.txt, 
THE JUNGLE BOOK By Rudyard Kipling.txt, 
Great Expectations - Charles Dickens.txt, 
The Moonstone - Wilkie Collins.txt, 
